48 12
0 804
0  0  0  0  0  0  0  0  0  0  0  0  0  0  0  0  0  0  0  0  0  0  0  0  0  0  0  0  0  0  0  0  0  0  0  0  0  0  0  0  0  0  0  0  92 0  0  0
0  0  0  0  0  0  0  99 0  0  0  0  0  0  0  0  0  0  0  0  0  0  0  0  0  0  0  0  0  0  0  0  99 0  0  0  0  0  0  0  0  0  0  55 77 0  99 0
0  0  0  0  0  91 0  44 0  0  0  0  0  0  0  0  0  0  0  0  0  0  0  0  0  0  0  99 91 0  0  0  93 0  0  0  0  0  0  0  0  0  90 0  0  0  93 0
0  0  0  44 0  44 0  0  0  91 99 92 0  0  0  0  0  0  0  0  0  0  0  0  0  92 0  55 66 77 0  55 77 0  0  0  0  0  0  0  0  99 0  0  0  55 77 0
0  93 91 0  0  0  0  0  0  55 66 77 0  0  0  0  0  0  0  0  0  0  44 0  0  44 0  0  0  0  0  0  90 0  93 0  0  0  0  0  0  55 66 77 0  0  0  0
0  55 66 77 0  99 0  0  0  0  0  0  0  91 0  0  0  0  0  0  0  90 0  0  0  91 0  93 0  0  93 99 0  0  93 0  0  0  0  44 0  0  93 0  0  0  0  0
91 0  0  0  0  93 0  90 0  0  0  0  0  44 0  0  0  0  0  0  99 91 0  0  0  55 66 77 0  0  55 66 66 66 77 0  0  0  0  0  0  55 77 0  91 0  55 77
55 77 0  0  0  93 93 92 0  0  0  90 0  0  0  0  0  44 0  0  55 66 66 77 0  0  0  0  0  0  0  0  0  0  0  0  0  0  0  93 0  99 0  0  44 0  99 0
0  0  0  0  0  55 66 66 77 0  0  91 0  0  0  0  0  0  0  0  0  0  0  0  0  0  0  0  0  0  0  0  0  0  0  0  0  91 0  55 66 66 77 0  0  92 55 77
0  0  90 0  0  0  0  0  0  0  55 66 66 77 0  0  0  0  0  0  0  0  90 0  0  0  0  0  0  0  0  0  0  0  0  0  55 77 0  0  90 0  0  0  0  44 0  0
0  91 6  92 0  0  0  0  93 92 0  0  91 0  99 0  0  0  91 99 0  92 0  0  91 0  0  0  0  0  0  0  0  0  0  0  0  0  0  99 92 0  0  44 0  0  0  0
11 22 22 22 33 0  0  11 22 33 0  11 22 22 33 0  0  0  11 22 22 22 22 22 33 0  0  0  0  0  0  0  0  0  0  0  0  0  0  11 22 33 0  0  0  0  0  0


0  1  2  3  4  5  6  7  8  9  10 11 12 13 14 15 16 17 18 19 20 21 22 23 24 25 26 27 28 29 30 31 32 33 34 35 36 37 38 39 40 41 42 43 44 45 46 47