48 12
0 804
0 0 0 0 0 0 0 0 0 0 0 0 0 0 0 0 0 0 0 0 0 0 0 0 0 0 0 0 0 0 0 0 0 0 0 0 0 0 0 0 0 0 0 0 0 0 0 0
0 0 5 0 0 0 0 0 0 0 0 0 0 0 0 0 0 0 0 0 0 0 0 0 0 0 0 0 0 0 0 0 0 0 0 0 0 0 0 0 0 0 0 0 5 0 0 0
0 0 7 0 6 0 7 0 0 0 0 0 4 0 0 0 0 0 0 0 0 0 0 0 0 0 0 0 0 0 4 0 0 0 0 0 0 0 0 0 0 0 0 0 0 0 7 0
0 0 1 2 2 2 2 3 0 0 0 0 4 0 0 0 0 0 0 0 5 0 0 0 0 0 7 0 0 0 4 0 0 0 6 7 0 0 0 0 0 0 0 0 1 2 3 0
4 0 0 7 0 0 0 0 0 0 0 4 4 0 0 0 0 0 0 0 0 0 6 0 7 0 1 3 0 0 4 0 0 1 2 2 2 3 0 0 0 0 0 0 0 0 0 0
1 2 2 3 0 0 0 0 0 0 0 4 4 0 0 0 0 0 0 0 1 2 2 2 3 0 0 0 0 0 4 4 0 5 0 0 0 4 0 0 0 0 0 0 0 0 0 0
0 0 0 0 0 4 0 0 0 0 1 2 3 0 0 0 7 0 4 0 0 0 0 0 0 0 0 0 0 0 1 2 3 0 0 0 0 4 0 0 0 5 0 0 0 0 0 0
0 0 1 2 3 4 0 0 0 0 0 0 0 7 0 0 1 2 3 0 0 0 0 0 0 0 0 0 0 0 0 0 0 1 3 0 0 4 0 0 0 0 7 0 0 0 0 0
4 0 7 0 0 4 0 0 0 0 0 0 1 2 3 0 0 0 0 0 0 0 0 0 0 0 0 0 0 0 0 0 0 0 0 0 1 3 0 0 0 1 3 0 0 0 1 3
1 2 3 0 0 4 0 0 0 0 4 0 0 0 0 0 0 0 0 0 5 0 0 0 0 0 0 0 4 0 0 0 0 0 0 4 0 0 0 0 5 0 0 0 0 0 0 0
0 6 0 7 4 4 0 7 0 4 4 6 0 0 0 0 0 0 6 7 0 0 7 0 0 0 0 0 4 4 0 0 0 0 4 4 7 0 0 0 0 0 7 0 0 0 0 0
1 2 2 2 2 3 0 1 2 2 2 3 0 0 0 0 0 1 2 2 2 2 2 3 0 0 0 0 1 2 3 0 0 1 2 2 2 3 0 0 1 2 3 0 0 0 0 0

0 1 2 3 4 5 6 7 8 9 0 1 2 3 4 5 6 7 8 9 0 1 2 3 4 5 6 7 8 9 0 1 2 3 4 5 6 7 8 9 0 1 2 3 4 5 6 7